21
21
xxxxxxxxxxxxxxxxxxxxx
x x   x       x     x
x x x x xxx x x xxx x
x   x   x x x x x   x
x xxxxxxx x x xxx x x
x   x     x x     x x
xxx xxx x x xxxxxxx x
x x x   x x x       x
x x x xxxxx xxxxxxx x
x x x     x x     x x
x x xxxxx x x xxx xxx
x   x   x x   x x   x
x x x x x xxxxx xxxxx
x     x           x x
xxxxxxxxxxxxxxxxx x x
x   x     x     x x x
x x x x xxx x x x x x
x x x x x   x x x x x
x x x x x xxx xxx x x
x x   x    $x       x
xxxxxxxxxxxxxxxxxxxxx