9
8
xxxxxxxx
x      x
x x x  x
x x x  x
x xxx  x
x   x  x
x x xxxx
x   x $x
xxxxxxxx